x x x x x x x x x x x x x
x p x p x p x p x p x p x
x p x p x p z p x p x p x
x p x p x p p p x p x p x
x p x p x x x x x p x p x
x x x x x p x p x x x x x
x x p p x x x x x p p x x
x x x x x p p p x x x x x
x p x p x p p p x p x p x
x p x p x p x p x p x p x
x p x p x x x x x p x p x
x x x x x x x x x x x x x